{
  Aperture: 'F値(絞り)',
  Artist: '','作者',
  ColorSpace: '','	色空間情報',
  Copyright: '','著作権者',
  DateTimeOriginal: '作成日時',
  ExifImageHeight: '高さ',
  ExifImageWidth: '幅',
  ExifVersion: 'EXIFバージョン',
  ExposureMode: '露出モード',
  ExposureProgram: '露出プログラム',
  ExposureTime: '露出時間',
  Flash: 'Flash',
  FocalLength: '焦点距離',
  FocalLength35efl: '',
  FocusMode: 'フォーカスモード',
  ISO: 'ISO',
  LensID: 'レンズ',
  LensModel: 'レンズモデル名', // LendsIDが空の場合
  Make: 'メーカー',
  MaxFocalLength: '',
  Megapixels: '',
  MeteringMode: '',
  MinFocalLength: '',
  Model: 'モデル',
  ModifyDate: '更新日時',
  MultiExposureShots: '',
  Orientation: '方向',
  ShutterSpeed: 'シャッター速度',
}
